NO ./img/bny_small.xpm
SO ./img/bny_pool.xpm
WE ./img/dungeon1.xpm
EA ./img/dungeon2.xpm

C 0,0,255
F 0,128, 0

1111111111111111111111111
1000000000110100000000001
1011000001110100000000001
100100000000000000000001
010000000011000001110111111111111
111111111011000001110000000000001
100000000000000001111111111011111
11110111111111011100000010001
111101111111110111010100100010
11000000110101011100000010001
10001000010000001100000010101
10000000000000000001010001011
10000001110101011111010000111
10110111 1110101 1011110W1111
11111111 1111111 111111111111