NO ./img/bny_big.xpm
SO ./img/flag.xpm
WE ./img/flag.xpm
EA ./img/bny_small.xpm
F 220,100,0
C 225,30,0

1111111111111111111111111
1000000000110000000000001
1011000001110000111010001
1001000001110000000010001
1111111111111011111110001
1000000000000000011010001
1011101011101011001000001
1010101010101011111011111
1011101011101011111000011
10000000111000W0000000001
1110111011111010101010101
1110111011111010101010101
1110000011111000101010101
1111111111111111111111111